NO ./texture/catnap.xpm
WE ./texture/Smiling_Critters.xpm
EA ./texture/dogday.xpm
SO ./texture/hoppy.xpm
C 156,255,100
F 130,12,104



11111111111
10011100001
10000000001
100000W0001
10000000001
10000000001
11111111111
